35 35
00000000000000000000000000000000000
01567424253534867447235355068367230
08080000040200040000000700070000000
04044257070577042548070602450232070
05000000000006000200030003000700030
04273523677808680754727222020327040
06000800050000000003000700060500070
04360778044854080302880272566367270
07070000040008030500000006000000000
02077488088703032835283705752834580
07030000060005020003000000000507020
08074324030684387708484674370704030
08080600060000000700000200080403000
04050564024634580356770657060502420
04050708000000000005000700050202000
07020207646665320704840687030304620
06000604050307050500000508000003030
06075302080507066532820506530463030
08020208070802000606000700000805070
05050703020704350808080766040304080
07040508080004000800060000050000030
02030303073603220755345666737607880
06080005040800000000080708000005050
04072202030678565245080502788606030
08020004080602030500000000040006050
02070533050208050367563752044303070
04080402020600070402070200050600080
07080307080728020305050527040475040
02050502000508000500030700000805050
03080703840306044873080545860504040
06060402000800040200000503000304000
02040802430786050624420708480403520
03020005000006000600020000000600000
04030673666708540832055448230576290
00000000000000000000000000000000000
