11 11
00000000000
01562434840
05000000000
03287605860
04000006000
04226665270
08030800000
06050328480
04000804080
07470404090
00000000000
